

T-Spin triple combo
OOOOOOOOOO
OOOOOOOOOO
OOOOOOOOOO
OOOOOOOOOO
OOOOOOOOOO
OOOOOOOOOO
OOOOOOOOOO
OOOOOOOOOO
OOOOOOOOOO
OOOOOOOOOO
OOOOOOOOOO
OOOOOOOOOO
OOOOOOOOOO
OOOOOOOOOO
XOOOOOOOOO
XOOXXOOOOO
XOOOXXXXXX
XXXOXXXXXX
XXOOXXXXXX
XXXOXXXXXX